NO ./textures/bark.xpm
SO ./textures/bricks.xpm 
EA ./textures/wood.xpm
WE ./textures/wood.xpm

F 32, 32, 32
C 0, 0, 102

111111111111111111111
1W0000000000000000001
111111111111111111111
