NO ./pics/redbrick.xpm
SO ./pics/redbrick.xpm
EA ./pics/redbrick.xpm
WE ./pics/redbrick.xpm

F 100, 56, 56
F 100, 56, 56
C 127, 50, 50

11111111
10000001
100N0001
10000001
11111111