NO ./textures/bark.xpm
SO ./textures/bricks.xpm 
EA ./textures/wood.xpm
WE ./textures/wood.xpm

F 32, 32, 32
C 0, 0, 102

1111111
1111111
1111111
1111111