NO ./pics/redbrick.xpm
SO ./pics/redbrick.xpm
WE ./pics/redbrick.xpm
EA ./pics/redbrick.xpm

F 18,53,25
C 153,204,255

1111111
1111111
1111111
1111111